A


B
bar = bilah

C
cancel = batal
cell = sel
close = tutup
column = kolom
content = konten
copy = salin (kk), salinan (kb)
custom = tersuai (misal : custom color = warna tersuai)

D
default = baku, bawaan
delimiter = pembatas
description = deskripsi, keterangan
digital = digital
disable = matikan
disabled = dimatikan
disc = ?
disk = ?
document = dokumen
download = unduh

E
email = surel
enable = nyalakan
enabled = dinyalakan
error = galat
export = ekspor

F
field = isian, kolom, field
file = berkas
format = format

G
grid = kisi

H


I
import = impor
insert = sisip

J


K


L
library = pustaka
libraries = pustaka

M
margin = batasan

N
number = angka

O
option = opsi, pilihan
overwrite = menimpa

P
pause = jeda (kb) menjeda (kk)
preview = pratinjau
printer = pencetak

Q


R
radix = akar
recent = baru-baru ini, terkini
region = wilayah
range = rentang
restart = mulai ulang
row = baris


S
setting = pengaturan
shape = bentuk
shortcut = pintasan
slide = salindia
separator = pemisahh

T
template = templat
text = teks
toolbar = bilah alat

U
upload = unggah
user = pengguna
username = nama pengguna

V
view = tampilan

W
worksheet = lembar kerja

X


Y


Z
